111111111
1EC00P001
111111111
