1111111111111111
11011000C00E0001
100000000000P001
1111111111111111
