1111111111111111
11111000000000C1
1111111111111011
11010C000100C011
110010C001011111
10P000010000E011
1011101111111011
1011101110001011
1011100100100011
100C110001111111
1111111111111111
